vv######v
vv#vvvv#v
vv#vvvv##
###vv$vv#
#0vv$#0##
###v$vvv#
vv###0vv#
vvvv#####

