###########
##vv#######
##v0#vvv###
##vvvv#v$v#
##vv###vvv#
#v$vvv0v$##
###v###vv##
##v0vv#vv##
##vv#vvv###
##vv#######
###########
