v###########v
v#####vvvv##v
##vv##vvvvv##
#vv0vvv#0vvv#
#vv#v#$#v#vv#
#vv$v$v$vv0##
#vv###$##vv#v
#vv0##vv0vv#v
###v#vvvvv##v
vv#vvv##vv#vv
vv#########vv